-------------
        P   *
   **       *
   **       *
  K       D *
 * * * * * **
-------------