K --------
|        |
| *** ** |
| *    * |
| *  * * |
| **P****|
| *      |
| * *  * |
|**** ***|
|   *    D
| *    * |
----------