----------------
|              |
| *  *P*  ***  |
| *  ***    *  |
| *         * D|
|K*            |
----------------